NO ./texture/wall_brick.xpm
EA ./texture/wall_stone3.xpm 
WE ./texture/wall_stone2.xpm
SO ./texture/wall_stone1.xpm
F 92,72,40
C 170,237,250
sky ./texture/skybox.xpm
floor ./texture/floor.xpm
sprite ./texture/monster.xpm
        111 
        101      
11111111000111111111
10000000010000000001111111
11110010010X000000110000001
    10000100011000000001001111
  11001111000110001101011110001
  100010000X00111111010001001001
111010100000001000000111001001001111
1010101111N0101011111   1001001000001
1000100000001000010001 11100100101101
 10011101001011011011 100010001000101
1001010010000100000001101001110000101  
1100000111100011111101100100111101001
  11111    111     101 1011000001001
                   1001001 11110001
                    10001      111
                     111