NO ./texture/wall_brick.xpm
SO ./texture/wall_stone1.xpm
WE ./texture/wall_stone2.xpm
EA ./texture/wall_stone3.xpm
sky ./texture/skybox2_dark.xpm
floor ./texture/floor.xpm
C 170,237,240
F 92,72,40

11111111111111111111
10000000010000000001111111
111100100100000000110000001
    10000100011000000001001
11110000000001100011011111
111000000000001111111111
111000000000001111111111
10100000000E0000010001
1000100000000000010011
 10000001001011011011
10010000100000000001
11111001111111111111
     11