NO ./texture/wall_brick.xpm
EA ./texture/wall_stone3.xpm 
WE ./texture/wall_stone2.xpm
SO ./texture/wall_stone1.xpm
F 92,72,40
C 170,237,250
sky ./texture/skybox.xpm
floor ./texture/floor.xpm
sprite ./texture/monster.xpm
door ./texture/door2.xpm


1111111111111
1111111111111
1110000000001
1D10000000001
11111D1111D11
1000000000001
10X0000000X0111111111
1000100000001000000D01
1000100000001000000101
10000S100000D0000X10001
100000000000100001000001
111111101111111111000001
1000000000D00D0000100X1
1111111111111111011011
111000011111111101101
111X11011111111101101
111011000000000001101
111011000000000001101
111011000000000001101
111011111111111111101
111000000000000000001
111111111111111111111