NO ./texture/wall_brick.xpm
EA ./texture/wall_stone3.xpm 
WE ./texture/wall_stone2.xpm
SO ./texture/wall_stone1.xpm
F 92,72,40
C 170,237,250
sky ./texture/skybox.xpm
floor ./texture/floor.xpm
sprite ./texture/monster.xpm
door ./texture/door2.xpm
key ./texture/key.xpm
potion ./texture/potion.xpm


11111111111111111111111
1D1111111111100000D00001
111000P00000100000100001 1
100000000000100P00100001101
11111D1111D1100000100001101
1000000000001000001000010X01
10X0000000X01111D11110010001
1000100000001000000D01D10001
1000100000001000000101000001
10000E0000K0D0000X100010011
1000000000001000010000011
11111D101111111111000001
1000000000D00D0000100X1
1111111111111111011011
 11000011111111101101
 11X11011111111101101
 11011000000000001101
 1101100000K000001101
 11011000000000001101
 11011111111111111101
 11000000000000000001
 11111111111111111111