NO ./texture/wall_brick.xpm
EA ./texture/wall_stone3.xpm 
WE ./texture/wall_stone2.xpm
SO ./texture/wall_stone1.xpm
F 92,72,40
C 170,237,250
sky ./texture/skybox.xpm
floor ./texture/floor.xpm
sprite ./texture/monster.xpm
door ./texture/door2.xpm


1111111111111
1000000000001
1X00000000001
1000000000001
1000000000001
10000N0000001
1000000000001
1111111111111