NO ./texture/wall_brick.xpm
EA ./texture/wall_stone3.xpm 
WE ./texture/wall_stone2.xpm
SO ./texture/wall_stone1.xpm
F 92,72,40
C 170,237,250
sky ./texture/skybox.xpm
floor ./texture/floor.xpm
sprite ./texture/monster.xpm
door ./texture/door.xpm


        111 
        101      
11111111000111111111
1D1X0000010100000001111111
111100100100000000110000001
    10000100011000000000001111
  11001D11D11110001100000110001
  100010000000100001000001001001
111010D0000000D000000111001001001111
1010101000N0001011111   1001001000001
100010D0000000D0010001 11100100101101
 100001111D1D11011011 100010001000101
1001010010000100000001101001110000101  
1100000111100011111101100100111101001
  11111    111     101 1011000001001
                   1001001 11110001
                    10001      111
                     111