NO ./texture/wall_brick.xpm
EA ./texture/wall_stone3.xpm 
WE ./texture/wall_stone2.xpm
SO ./texture/wall_stone1.xpm
F 92,72,40
C 170,237,250
sky ./texture/skybox.xpm
floor ./texture/floor.xpm
sprite ./texture/monster.xpm
door ./texture/door2.xpm
door_locked ./texture/door_locked.xpm
key ./texture/key.xpm
potion ./texture/potion.xpm


11111111111111111111111
1D1110000111100000D00001
111000P00000100000100001 1
100000000000100P001000011K1
11111D1111D1100000100001101
1000000000001000001000010X01
10X0000000X01111D11110010001
1000100000001000000D01D10001
1000100000001000000101000001
10000E0000K0D0000X100010011
1KKK000000001000010000011
11111D1011111111110000K111111111111111111
1000000000D00D0000100X100000000000P0000XK1
11111111111111110110100000000000000000011
 110000D000P1111011010000000000000000001
 11X1101111111110110111111111111111D11111111
 11011000000000001101000000001000000000000001
 1101100000K000001101000000001001111111110001
 11011000000000001101000000001001K000000P0001
 1101111111111111110100K000000000000000000001
 1100000000000000000111111111111111111111111
 11111111111111111111