NO ./texture/wall_brick.xpm
EA ./texture/wall_stone3.xpm 
WE ./texture/wall_stone2.xpm
SO ./texture/wall_stone1.xpm
F 92,72,40
C 170,237,250
sky ./texture/skybox.xpm
floor ./texture/floor.xpm
sprite ./texture/monster.xpm
door ./texture/door2.xpm


1111111111111
1D10000000001
11111D1111D11
1000000000001
10X0000000X0111111111
10001000000000000001
10001000000010000001
10000N100000D1000X1
100000000000100001
111111111111111111