NO ./path_to_the_north_texture
SO ./path_to_the_south_texture
WE ./path_to_the_west_texture
EA ./path_to_the_east_texture
F 220,100,0
C 255,30,0


1111111
100001111
100000001
1000S0001
100001111
111111

1111
10011     1111
10011111111001
1000000000000011
11111111111111


