NO ./path_to_the_north_texture
SO ./path_to_the_south_texture
WE ./path_to_the_west_texture
EA ./path_to_the_east_texture
F 220,100,0
C 255,30,0

111111111111111
100000000100001
100000000100001
100000000100001
100000000000011
101010101000011
100000000000001
10000001N010001
100000001000001
111111111111111


