NO ./path_to_the_north_texture
SO ./path_to_the_south_texture
WE ./path_to_the_west_texture
EA ./path_to_the_east_texture
F 220,100,0
C 255,30,0

11111111111111
1000000N001011
10000000001011
10011111000011
10010001110011
10000000010011
11111111111111


