NO ./texture/wall_brick.xpm
EA ./texture/wall_stone3.xpm 
WE ./texture/wall_stone2.xpm
SO ./texture/wall_stone1.xpm
F 92,72,40
C 170,237,250
sky ./texture/skybox.xpm
floor ./texture/floor.xpm
sprite ./texture/monster.xpm
flashlight ./texture/flashlight.xpm
door ./texture/door.xpm
        
11111111111111111111111111111111111111111111111111111111
100000000000000000X0000000000000000X00000000000000000001
10000111111111111111111111111111111111111111111111100001
10000000000000000000000000000000000000000000000000000001
10000000001000000000000000000000000000000000000000000001
10000000001000000000001000000000111111111111110111111111
10000X00001000000000001000000000100010000010010100000001
100000000010000000000010000000001011100100100000001110X1
100000000000000000000010000N0000100X00010000010100000001
10000000000000111111111111111111111111111111111111111111
10000000000000100000001000000000000100000000000000000001
10000111111000100000001000X0000X000100000000000000000X01
10000X0000000000000000100000000000010000000000000X000001
10000000001110000000001000000000000100000000X00000000001
1111111111111111110000100000000000010000X000000000000001
10000X01000000000000001000000000000000000000001111111101
1000000100000000000000100000000000000000000000100X000101
10000000000111111111111000000000000100000000001000000101
10000000000000000000000000000000000100000000001000000001
11111111111111111111111111111111111111111111111111111111