NO ./texture/wall_brick.xpm
SO ./texture/wall_stone1.xpm
WE ./texture/wall_stone2.xpm
EA ./texture/wall_stone3.xpm
C 170,237,240
F 92,72,40

111111111111111
100000000100001111111111
111110W001000110000000001
    100001000000000000001
111101000000011111111111
101000101000011
100010000000111
 10000010011
 10010000001
 10000001001111
100100001000001
111111111111111






