NO ./texture/wall_brick.xpm
EA ./texture/wall_stone3.xpm 
WE ./texture/wall_stone2.xpm
SO ./texture/wall_stone1.xpm
F 92,72,40
C 170,237,250
sky ./texture/skybox.xpm
floor ./texture/floor.xpm
sprite ./texture/monster.xpm
flashlight ./texture/flashlight.xpm
        
        111        
11111111000111111111       111111111
1000X00000000000000011111110000000001
1111001000000000000110000001000S000001
    1000010001100000000100111100000001
  110011110001100011010111100011110111
  1000100001001100110100010010010000001111
1110101000001010000001110010000000000011001111
101010111100101011111   1000X000000001101000001
100010000X001000010001 1110000X0110000000101101
 10011101001011011011 10001X0000110001101000101
10010100100001000000011010011010011111110000101  
1100000111100011111101100100111101001   1111 1
  11111    111     101 1011000001001
                   1001001 111100X1
                    10001      111
                     111