NO ./path_to_the_north_texture
SO ./path_to_the_south_texture
WE ./path_to_the_west_texture
EA ./path_to_the_east_texture
C 170,237,240
F 47,117,52

111111111111111
100000S00100001111111111111111111111111111111111
1111100001000110000000000000000000000000000000001
    100001000000000000000000000000000000000000001
111101000000011111111111111111111111111111111111
101000101000011
100010000000111
 10000010011
 10010000001
 10000001001111
100100001000001
111111111111111


